000000000000DDDD00000000DDUU0000000000
000000000000DDDD00000000DDUU0000000000
00000000UUDDDDDD00000000DD000000000000
00000000UUDDDDDD00000000DD000000000000
00000000UUDDDDDD00000000000000DDDD0000
00000000UUDDDDDD00000000000000DDDD0000
DDDD0000000000000000000000000000DDUU00
DDDD0000000000000000000000UUU000DDUU00
00UUUU0000DD00000D00000000U00000DDDD00
00UUUU0000DD00000D00000000UUU000DDDD00
00DDDD00000000000UU000000000U000D00000
00DDDD00000000000UU0000000UUU000D00000
00DDDDDDDD0000000DDDD0000000D000000000
00DDDDDDDD0000000DDDD0000000D000000000
00000000000000000DDDD000DDDDDDDD0000UU
00000000000000000DDDD000DDDDDDDD0000UU
0D00UUUU0000000000DDD000D000000000DD00
0D00U0U00000000000D00000D000000000DD00
0000UUU0000000000000000000000000000000
0000U000000000000000000000000000000000
0000U000000D000000000000000000UUDDDDDD
00000000000D0000000UU000000000UUDDDDDD
00DD000000000000000U0U0000DD0000000000
0000000000000000000U0U0000DD0000000000
00000000000000D0000U0U0000000000000000
00000000000000DD000UU00000000000000000
00000000000000000000000000DD0000DDDD00
0000000DD0000U000000000000DD0000DDDD00
UUUUDDDD00000UUU000DD00000DD0000DDDD00
000000000000U0U0DDDD0000000DDDD0000000
000000000000U0U0DDDD0000000UUUUU000000
00DD00000000000000DD0D0000000000U000DD
00DD00000000000000DD0D0000000000U000DD
DD00000000000000D0000DDD000000000000DD
000000DD00000000D000DD00000000000000DD
000000DD000000000000000000000DDD0000UU
000000UUDDD000000000000000000000000000
000000UUDDD000000000000000000000000000


